Rozmer:!10!
CelkovaDelka:!200!
E!c!Z!Z!S!Z!Z!c!Z!Z!
Z!c!c!c!Z!c!c!c!c!c!
Z!Z!Z!Z!Z!Z!c!Z!c!c!
c!c!c!c!c!c!c!c!c!c!
c!Z!Z!Z!Z!Z!Z!Z!c!c!
c!Z!c!c!Z!c!c!c!c!Z!
c!Z!c!c!c!Z!Z!Z!c!Z!
c!c!c!Z!Z!Z!Z!Z!c!Z!
Z!c!c!c!c!c!c!Z!Z!Z!
Z!c!Z!K!Z!Z!K!Z!cZ!