Rozmer:!10!
CelkovaDelka:!200!
Z ! c ! Z ! Z ! S ! Z ! Z ! c ! Z ! Z !
Z ! c ! c ! c ! Z ! E ! c ! c ! c ! Z !
Z ! Z ! Z ! Z ! Z ! Z ! c ! Z ! c ! Z !
c ! c ! c ! c ! c ! c ! c ! c ! c ! Z !
c ! Z ! Z ! Z ! Z ! Z ! Z ! Z ! c ! Z !
c ! Z ! c ! c ! Z ! c ! c ! c ! c ! Z !
c ! Z ! c ! c ! c ! Z ! Z ! Z ! c ! Z !
c ! c ! c ! Z ! Z ! Z ! Z ! Z ! c ! Z !
Z ! c ! c ! c ! c ! c ! c ! Z ! c ! Z !
Z ! c ! Z ! Z ! Z ! Z ! K ! Z ! Z ! Z !