PocetKostekHrana:!10!
CelkovaDelkaHrana:!1000!
E!c!Z!Z!S!Z!Z!c!Z!Z!
Z!c!c!c!c!c!c!c!c!c!
Z!Z!Z!Z!Z!Z!c!Z!c!c!
c!c!c!c!c!c!c!c!c!c!
c!Z!Z!Z!Z!Z!Z!Z!c!c!
c!Z!c!c!Z!c!c!c!c!Z!
c!Z!c!c!c!Z!Z!Z!c!Z!
c!c!c!Z!Z!Z!Z!Z!c!Z!
Z!c!c!c!c!c!c!Z!Z!Z!
Z!c!Z!Z!Z!Z!K!Z!c!c!