Rozměr:!5!
CelkováDélka:!100!
S ! Z ! Z ! Z ! Z ! 
c ! c ! c ! c ! c ! 
Z ! c ! Z ! Z ! c ! 
Z ! c ! Z ! Z ! c ! 
Z ! c ! Z ! Z ! K ! 